N.A.
- Jackson Lake - Grand Teton National Park, Wyoming, U.S.A.
- Cavern at Rocks National Lakeshore - Michigan, U.S.A.
- Glacier National Park - Montana, U.S.A.
- Banff National Park - Alberta, Canada
- Niagara Falls - Ontario, Canada and New York, U.S.A.
- Disney World - Florida, U.S.A.

S.A.
- Perito Moreno Glacier - Los Glaciares National Park, Argentina
- Laguna de Los Tres and Mount Fitz Roy - Pantagonia, Argentina
- Ruins of Machu Picchu - Urubamba, Cusco Region, Peru
- Huacachina Sand Dunes - Peru
- Salar de Uyuni - Bolivia

EU
- Halnaker, West Sussex, England
- Neuschwanstein Castle - Schwangau, Germany
- Bluebell Field - Minterne Magna, Dorset, England
- Eiffel Tower - Paris, France
- The Parthenon - Athens, Greece
- Glen Coe - Scotland
- Milan, Italy
- Ice Bubbles of Lago Bianco - Poschiavo, Switzerland

Af
- Tsitsikamma National Park - South Africa
- Cape Town - South Africa
- Sandwich Harbour - Namibia
- Underwater Waterfall - Le Morne, Mauritius
- Giza, Egypt

As
- National Center for Performing Arts, Beijing, China
- Guilin Hills, Guanxi, China
- Furano Flower Fields - Hokkaido, Japan
- Ta Pa Rice Fields - Mekong Delta, Vietnam
- Fort Santiago - Intramuros, Manila, Philippines

Au
- Australian Savanna Grasslands
- Sydney Opera House - Sydney, Australia
- The Hobbiton - Matamata, New Zealand
- Waitomo Glowworm Caves - Waitomo, New Zealand
- Ngardmau Waterfalls - Babeldaob, Palau

ANTARCTICA - lmao